6 6
0 0 3 4 0 0
0 * 5 5 * 0
# 1 * 1 1 #
1 2 1 2 1 2
0 - 2 3 - 0
0 0 4 2 0 0